##########
#........#
#........#
#...@....#
#........#
#....^...#
####..####
   #..#
   #..#
   #..#
   #..#
   #..#
   #..#
   #..#
   #..#
   #..#
   #..#
   #..#
####..##########
#..............#                   ###########
#######...##...#                  #.........#
#.........##...####################.........#
#...........................................#
#...........................................#
#..............####################.........#
#..............#                  #.........#
#..........#...#                  ###########
#..............#
#..............#
#..##..........#
#..............#
#######..#######
      #..#
      #..#
      #..#
      #..#
      #..#
      #..#
      #..#
      #..#
#######..######
#.............#
#.............#
#..############
#.............#
#.............#
############..#
#.............#         ###########
#.............#         #.........#
#.............#         #.........#
#.............#         #.........#
#..######################.........#
#.................................#
#.................................#
#########################.........#
                        #.........#
                        #.........#
                        #.........#
                        ###########
