###########             ################
#.........#             #..............#
#.........#             #..............#
########..#             #..............#
#.........#             #..............#
#....@....#             #..............#
#.........###############..............#
####...................................#
#......................................#
#......#..###############..............#
#.........#             #..............#
#....^....#             ################
##........#
#.........#
###########