###########
#.........#
#.........#
########..#
#.........#
#....@....#
#.........#
####......#
#.........#
#......#..#
#.........#
#....^....#
##........#
#.........#
###########