##########                                                          ########
#........#          ################                                #......#
#........############..............#                       ##########......#
#...@....................#.........#                      ##...............#
#........................#.........#                     ##....######......#
#........############....#.........#        ##############....##    #......#
#....^...#          #....#.........#        #...........#....##     ########
##########          ######.........#        #...........#...##
                    #..............#        #...........#..##
                    #.......########        #...........#..#
                    #..............##########...........#..#
                    #...................................#..#
                    #...................................#..#
                    #..............##########...........#..#
                    #......##......#        #...........#..#
   #########        #......##......#        #...........#..#
   #.......#        #..............#        #..............#
   #.......###############.........#        #..............#
   #...............................#        ################
   #...............................#
   #.......#########################
   #.......#
   #########