##########                                                          ########
#........#          ################                                #......#
#........############..............#                        #########......#
#...@....................#.........#                       #...............#
#........................#.........#                      #....######......#
#........############....#.........#        ##############....#     #......#
#........#          #....#.........#        #...........#....#      ########
##########          ######.........#        #...........#...#
                    #..............#        #...........#..#
                    #.......########        #...........#..#
                    #..............##########...........#..#
                    #...................................#..#
                    #...................................#..#
                    #..............##########...........#..#
                    #......##......#        #...........#..#
   #########        #......##......#        #...........#..#
   #.......#        #..............#        #..............#
   #.......###############.........#        #..............#
   #...............................#        ################
   #...............................#
   #.......#########################
   #.......#
   #########